Account,Amount,Description,Available Balance,Date
0756299000,NGN5000.0 CR,Bank Deposit,5000.0,2024-01-28 12:27
0756299000,NGN5000.0 CR,Bank Deposit,10000.0,2024-01-28 12:27
0756299000,NGN500.0 CR,Bank Deposit,10500.0,2024-02-01 17:15
0756299000,NGN1500.0 DR,Bank Withdrawal,9000.0,2024-02-01 17:16
0756299000,NGN500.0 CR,Bank Deposit,9500.0,2024-03-15 22:13
0756299000,NGN500.0 DR,Bank Transfer DR,9000.0,2024-03-15 22:15
